##########
#A     ###
### ##   #
#   # #  #
# ### ## #
#    #   #
#### #####
#  #    ##
# ###   B#
##########