##################
#A #   ######    #
#  #   #    #    #
#  ###### ## #   #
#        #  #    #
###### # # ## #  #
#    # # # #  #  #
# ## # # # ## #  #
# #  #     #    B#
# ###### ####### #
#                #
##################
