##########
#A#    ###
# ### ####
# #      #
# ###### #
#  #  #  #
###  # ###
#  ####  #
#     # B#
##########